1111111111111111111111111111111111
1000000000000000000000000000000001
1010010101100000101001000000010101
101001001C101010001001000000010101
1P0000000001E000000000000000000001
1111111111111111111111111111111111