11111111
1ECCCCC1
11100101
1P100001
11111111