11111111111111
1E010001111111
101C1101000001
1P110001000001
11111111111111

